111111111111111111111111111111
100000001000000000000000000001
100000101111111100000101000001
100111101000000000010101111001
100100001000111111110101001001
100100001000001000010101001001
100111101010001000010101001001
100000000010000000010100001101
111111111010100010000100000001
100000001010100010110111111111
100000001010111110010100000001
100111101010001000010101111001
100000101000001000000001000001
100100101010001111110101111001
100100101010000000000100001001
100100100010001000100100001001
100111111110111100100101111001
100000001000001001101100000001
100000000000000000000100000001
111111111111111111111111111111














